--------------------------------
--11---------33--------44-------
--11---------33--------44-------
--------------------------------
--------------------------------
-----------5522--------66-------
-----------5522--------66-------
--------------------------------
-----77------88--------99-------
-----77------88--------99-------
--------------------------------
--------------------------------
--------------------------------
--------------------------------
--------------------------------
--------------------------------
--------------------------------
--------------------------------
1 CP  100 200
2 CE1  50  100
3 CP  100 200
4 CP  100 200
5 CP  100 200
6 CP  100 200
7 CP  100 200
8 CP  100 200
9 CP  100 200
