--------------------------------
--11----XX-XX33--------44-------
--11----XX-XX33--------44-------
--------------------------------
-------------XX-----------------
-----------XX22X-------66-------
-----------XX22X-------66-------
-------------XX-----------------
-----77------88--------99-------
-----77------88--------99-------
--------------------------------
--------------------------------
--------------------------------
--------------------------------
--------------------------------
--------------------------------
--------------------------------
--------------------------------

1 CP  100 200
2 CE1 50  100
3 CP  100 200
4 CP  100 200
6 CP  100 200
7 CP  100 200
8 CP  100 200
9 CP  100 200
