--------------------------------
--------XX-XX33--------44-------
--------XX-XX33--------44-------
--------------------------------
--------------------------------
-------------22--------66-------
-------------22--------66-------
--------------------------------
-----77------88--------99-------
-----77------88--------99-------
--------------------------------
--------------------------------
--------------------------------
--------------------------------
--------------------------------
XXX-----------------------------
11X-----------------------------
11X-----------------------------

1 CP  100 200
2 CE1 100 200
3 CE1 99  200
4 CE1 101 200
6 CE2 100 200
7 CE2 99  200
8 CE2 100 200
9 CP  100 200
