XXXXXXXXXXXXXXXXXXXXXXXXXXXXXXXX
XXXXXXXXXXXXXXXXXXXXXXXXXXXXXXXX
---------------XX---------------
---------11----XX----44---------
---------11----XX----44---------
---------------33---------------
---------------33---------------
---------22----XX----55---------
---------22----XX----55---------
---------------XX---------------
---------------XX---------------
XXXXXXXXXXXXXXXXXXXXXXXXXXXXXXXX
XXXXXXXXXXXXXXXXXXXXXXXXXXXXXXXX
XXXXXXXXXXXXXXXXXXXXXXXXXXXXXXXX
XXXXXXXXXXXXXXXXXXXXXXXXXXXXXXXX
XXXXXXXXXXXXXXXXXXXXXXXXXXXXXXXX
XXXXXXXXXXXXXXXXXXXXXXXXXXXXXXXX
XXXXXXXXXXXXXXXXXXXXXXXXXXXXXXXX

1 CP  100 200
2 CP  100 100
3 CN  100 200
4 CE1 100 200
5 CE1 100 200
