--------------------------------
---------------11---------------
---------------11---------------
--------------------------------
------66---------------55-------
------66---------------55-------
--------------------------------
--------------------------------
---------------44---------------
-----88--------44--------99-----
-----88------------------99-----
--------------------------------
--------------------------------
--------------------------------
--22-----------77-----------33--
--22-----------77-----------33--
--------------------------------
--------------------------------

1 CP  101 200
2 CE1 100 200
3 CE2 100 200
4 CN  150 300
5 CN  100 200
6 CN  100 200
7 CN  100 200
8 CN  100 200
9 CN  100 200
